20:10
1:1:1:1:1:1:1:1:1:1:1:1:1:1:1:1:1:1:1:1
1:0:0:0:0:0:0:0:0:0:1:0:0:0:0:0:0:0:0:1
1:0:0:0:0:0:0:0:0:0:1:0:0:0:0:0:0:0:0:1
1:0:0:0:0:0:0:0:0:0:1:0:0:0:0:0:0:0:0:1
1:0:0:0:0:0:0:0:0:1:1:0:0:0:0:0:1:1:1:1
1:0:0:0:0:0:0:0:0:0:0:0:0:0:0:0:0:0:0:1
1:0:0:0:0:0:0:0:0:1:1:0:0:0:0:0:0:0:0:1
1:0:0:0:0:0:0:0:0:0:1:0:0:0:0:0:0:0:0:1
1:0:0:0:0:0:0:0:0:0:1:0:0:0:0:0:0:0:0:1
1:1:1:1:1:1:1:1:1:1:1:1:1:1:1:1:1:1:1:1
3:3:-1
18:3:1
18:3:1
9:5:1