20:10
1:1:1:1:1:1:1:1:1:1:1:1:1:1:1:1:1:1:1:1
1:0:0:0:0:0:0:0:0:0:1:0:0:0:0:0:0:0:0:1
1:0:0:0:0:0:0:0:0:0:1:0:0:0:0:0:0:0:0:1
1:0:0:0:0:0:0:0:0:0:1:0:0:0:0:0:0:0:0:1
1:0:0:0:0:0:0:0:0:1:1:0:0:0:0:0:1:1:1:1
1:0:0:0:0:0:0:0:0:0:0:0:0:0:0:0:0:0:0:1
1:0:0:0:0:0:0:0:0:1:1:0:0:0:0:0:0:0:0:1
1:0:0:0:0:0:0:0:0:0:1:0:0:0:0:0:0:0:0:1
1:0:0:0:0:0:0:0:0:0:1:0:0:0:0:0:0:0:0:1
1:1:1:1:1:1:1:1:1:1:1:1:1:1:1:1:1:1:1:1
3:3
3
18:3:1:10
18:2:0:20
9:5:1:10
1
1:18:7:30