20:13
1:1:1:1:1:1:1:1:1:1:1:1:1:1:1:1:1:1:1:1
1:0:0:0:0:0:0:0:0:0:1:0:0:0:0:0:0:0:0:1
1:0:0:0:0:0:0:0:0:0:1:0:0:0:0:0:0:0:0:1
1:0:0:0:0:0:0:0:0:0:1:0:0:0:0:0:0:0:0:1
1:0:0:0:0:0:0:0:0:0:1:0:0:0:0:0:1:1:1:1
1:0:0:0:0:0:0:0:0:0:0:0:0:0:0:0:0:0:0:1
1:0:0:0:0:0:0:0:0:1:1:0:0:0:0:0:0:0:0:1
1:0:0:0:0:0:0:0:0:0:1:0:0:0:0:0:0:0:0:1
1:0:0:0:0:0:0:0:0:0:1:0:0:0:0:0:0:0:0:1
1:0:0:1:1:1:1:1:1:1:1:1:1:1:1:1:1:1:1:1
1:0:0:1:1:1:1:1:1:1:1:1:1:1:1:1:1:1:1:1
1:0:0:1:1:1:1:1:1:1:1:1:1:1:1:1:1:1:1:1
1:1:1:1:1:1:1:1:1:1:1:1:1:1:1:1:1:1:1:1
3:3
3
5:5:1:5
18:3:1:30
13:8:0:10
