20:13
1:1:1:1:1:1:1:1:1:1:1:1:1:1:1:1:1:1:1:1
1:0:0:0:0:0:0:0:0:0:1:0:0:0:0:0:0:0:0:1
1:0:0:0:0:0:0:0:0:0:1:0:0:0:0:0:0:0:0:1
1:0:0:0:0:0:0:0:0:0:1:0:0:0:0:0:0:0:0:1
1:0:0:0:0:0:0:0:0:0:1:0:0:0:0:0:1:1:1:1
1:0:0:0:0:0:0:0:0:0:0:0:0:0:0:0:0:0:0:1
1:0:0:0:0:0:0:0:0:1:1:0:0:0:0:0:0:0:0:1
1:0:0:0:0:0:0:0:0:0:1:0:0:0:0:0:0:0:0:1
1:0:0:0:0:0:0:0:0:0:1:0:0:0:0:0:0:0:0:1
1:0:0:1:1:1:1:1:1:1:1:1:1:1:1:1:1:1:1:1
1:0:0:1:1:1:1:1:1:1:1:1:1:1:1:1:1:1:1:1
1:0:0:1:1:1:1:1:1:1:1:1:1:1:1:1:1:1:1:1
1:1:1:1:1:1:1:1:1:1:1:1:1:1:1:1:1:1:1:1
3:3:-1
5:5:1
18:3:2
13:8:0